#S#################
#.....####.....####
####..#############
####.#########.####
####.#########.####
####...#######.####
######.#####...####
#####..###..#######
#.....####....#####
##.##.#############
##.##........######
##.#########.######
##....######.#...##
#####.##..##.######
#####.####...######
#####.####.########
##...............##
################.##
###..............##
###E###############

####################
#.....####.....####
####S.#############
####.#########.####
####.#########.####
####...#######.####
######.#####...####
#####..####....####
#.....###........##
#####.#############
#####........######
##......####.######
############.######
########..##.#...##
##########..#######
##########.########
##...............##
###################
###..............##
###E###############
